{
  "stageId": "test",
  "width": 1600,
  "height": 900,
  "spawnX": 288,
  "spawnY": 288,
  "music": "test_music.mp3",
  "tileset": "test_tilemap.png",
  "tilesize": 144,
  "tilemap": [
    [0, 0, 0, 0, 0, 0, 0, 0, 0, 0, 0, 0],
    [0, 0, 1, 1, 1, 1, 1, 1, 1, 1, 1, 0],
    [0, 1, 1, 1, 1, 1, 1, 1, 1, 1, 1, 0],
    [0, 1, 1, 1, 1, 1, 1, 1, 1, 1, 1, 0],
    [0, 1, 1, 1, 1, 1, 1, 1, 1, 1, 1, 0],
    [0, 1, 1, 1, 1, 1, 1, 1, 1, 1, 1, 0],
    [0, 1, 1, 1, 1, 2, 2, 2, 2, 2, 2, 2],
    [0, 1, 1, 1, 1, 2, 2, 2, 2, 2, 2, 2],
    [0, 0, 0, 0, 0, 2, 2, 2, 2, 2, 2, 2]
  ],
  "collision": [
    [1, 1, 1, 1, 1, 1, 1, 1, 1, 1, 1, 1],
    [1, 1, 0, 0, 0, 0, 0, 0, 0, 0, 0, 1],
    [1, 0, 0, 0, 0, 0, 0, 0, 0, 0, 0, 1],
    [1, 0, 0, 0, 0, 0, 0, 0, 0, 0, 0, 1],
    [1, 0, 0, 0, 0, 0, 0, 0, 0, 0, 0, 1],
    [1, 0, 0, 0, 0, 0, 0, 0, 0, 0, 0, 1],
    [1, 0, 0, 0, 0, 1, 1, 1, 1, 1, 1, 1],
    [1, 0, 0, 0, 0, 1, 1, 1, 1, 1, 1, 1],
    [1, 1, 1, 1, 1, 1, 1, 1, 1, 1, 1, 1]
  ],
  "enemies": [
    { "type": "SLIME", "level": 2, "x": 1152, "y": 432 }
  ],
  "droppedItems": [
    { "type": "HEALTH_POTION", "x": 5, "y": 8 }
  ],
  "events": [
    { "trigger": "ENTER", "area": { "x": 20, "y": 10, "w": 5, "h": 5 }, "actionType": "SPAWN_WAVE" }
  ]
}